   

 
--------------------------------------------------
Données publiques ouvertes - Montpellier Territoire Numérique
--------------------------------------------------
Fiche métadonnées
--------------------------------------------------

* ID : 64

* TITRE : Comptage véhicules particuliers

* IDENTIFIANT : VilleMTP_MTP_Comptage_2012

* DESCRIPTION : Cette donnée renseigne le nombre de véhicules particuliers passant dans une rue, généralement durant une semaine. Les comptages les plus anciens datent de 1997 et les plus récents de 2011. La méthodologie est dite manuelle, car non permanente, il s’agit en général de l’utilisation d’un système pneumatique (piézoélectricité) qui consiste à placer deux tubes pneumatiques en caoutchouc en travers de la chaussée. 

Définition des champs : 

Vlegale : Vitesse autorisée 

Ddebut : Date de début de comptage 

Dfin : Date de fin de comptage 

Sens : Sens de circulation 

PHJM : Nombre d’unité de véhicules particuliers (UPV) 

PHJS : Nombre d’UPV à l’heure de pointe du soir 

TJM : Nombre d’UPV moyen

* COUVERTUTE GÉOGRAPHIQUE : Ville de Montpellier

* LANGUE : français

* DATE PUBLICATION : 2012-01-27

* PÉRIODE VALIDITÉE : Annuelle

* MISE À JOUR : 2012-01-27

* PRORIÉTAIRE : Ville de Montpellier

* DIFFUSEUR : Ville de Montpellier

* CATÉGORIE : Transport

* THÈME INSPIRE : Transport

* LICENCE : LICENCE OUVERTE / OPEN LICENCE http://www.etalab.gouv.fr/pages/licence-ouverte-open-licence-5899923.html

* MOTS CLÉS : comptage ; véhicule ; trafic ; voiture ; transport ; vitesse ; montpellier

* TARIFICATION : Gratuite





--------------------------------------------------
Site : http://opendata.montpelliernumerique.fr
--------------------------------------------------
